----------------------------------------
----------------------------------------
--------------------g3g3------g3g3g3g3--
----------------------------------------
----------------------------------------
----------g3g3g3g3g3g3------------------
----------------------------------------
----g300g3g3g3--------g3g3g3g3----------
----------------------------------------
----------------------------------------
--g3g3g3g3g3g3g3g3g3g3g3g3g3g3g3g3g3g3--
